#########################
#                       #
#         . ########    #
#           #.          #
#####  P  . ###         #
#   #                   #
#   # .      #######    #
#   ##       #Q         #
#                       #   
#########################